30
WWWWWWWWWWWWWWWWWWWWWWWWWWWWWW
WGGGGGGGGGGGGGGGGGGGGGGGGGGGGW
WGFFFFFFFFFFFFFFFFFFFFFFFFFFGW
WGFFFFFFFFFFFFFFFFFFFFFFFFFFGW
WGFFFFFFFFFFFFFFFFFFFFFFFFFFGW
WGFFFFFFFFFFFFFFFFFFFFFFFFFFGW
WGFFFFFFFFFFFFFFFFFFFFFFFFFFGW
WGFFFFFFFFFFFFFFFFFFFFFFFFFFGW
WGFFFFFFFFFFFFFFFFFFFFFFFFFFGW
WGFFFFFFFFFFFFFFFFFFFFFFFFFFGW
WGFFFFFFFFFFFFFFFFFFFFFFFFFFGW
WGFFFFFFFFFFFFFFFFFFFFFFFFFFGW
WGFFFFFFFFFFFFFFFFFFFFFFFFFFGW
WGFFFFFFFFFFFFFFFFFFFFFFFFFFGW
WGFFFFFFFFFFFFFFFFFFFFFFFFFFGW
WGFFFFFFFFFFFFFFFFFFFFFFFFFFGW
WGFFFFFFFFFFFFFFFFFFFFFFFFFFGW
WGFFFFFFFFFFFFFFFFFFFFFFFFFFGW
WGFFFFFFFFFFFFFFFFFFFFFFFFFFGW
WGFFFFFFFFFFFFFFFFFFFFFFFFFFGW
WGFFFFFFFFFFFFFFFFFFFFFFFFFFGW
WGFFFFFFFFFFFFFFFFFFFFFFFFFFGW
WGFFFFFFFFFFFFFFFFFFFFFFFFFFGW
WGFFFFFFFFFFFFFFFFFFFFFFFFFFGW
WGFFFFFFFFFFFFFFFFFFFFFFFFFFGW
WGFFFFFFFFFFFFFFFFFFFFFFFFFFGW
WGFFFFFFFFFFFFFFFFFFFFFFFFFFGW
WGFFFFFFFFFFFFFFFFFFFFFFFFFFGW
WGGGGGGGGGGGGGGGGGGGGGGGGGGGGW
WWWWWWWWWWWWWWWWWWWWWWWWWWWWWW
