30
WGWWWWWWWWWWWWWWWWWWWWWWWWWWGW
GFFFFFFFFFFFFFFFFFFFFFFFFFFFFG
WFFFFFFFFFFFFFFFFFFFFFFFFFFFFW
WFFFFFFFFFFFFFFFFFFFFFFFFFFFFW
WFFFWGWWWWWWWWWWWWWWWWWWGWFFFW
WFFFGFFFFFFFFFFFFFFFFFFFFGFFFW
WFFFWFFFFFFFFFFFFFFFFFFFFWFFFW
WFFFWFFFFFFFFFFFFFFFFFFFFWFFFW
WFFFWFFFWGWWWWWWWWWWGWFFFWFFFW
WFFFWFFFGFFFFFFFFFFFFGFFFWFFFW
WFFFWFFFWFFFFFFFFFFFFWFFFWFFFW
WFFFWFFFWFFFFFFFFFFFFWFFFWFFFW
WFFFWFFFWFFFFFFFFFFFFWFFFWFFFW
WFFFWFFFWFFFFFFFFFFFFWFFFWFFFW
WFFFWFFFWFFFFFFFFFFFFWFFFWFFFW
GFFFGFFFGFFFFFFFFFFFFGFFFGFFFG
WFFFWFFFWFFFFFFFFFFFFWFFFWFFFW
WFFFWFFFWFFFFFFFFFFFFWFFFWFFFW
WFFFWFFFWFFFFFFFFFFFFWFFFWFFFW
WFFFWFFFWFFFFFFFFFFFFWFFFWFFFW
WFFFWFFFGFFFFFFFFFFFFGFFFWFFFW
WFFFWFFFWGWWWWWWWWWWGWFFFWFFFW
WFFFWFFFFFFFFFFFFFFFFFFFFWFFFW
WFFFWFFFFFFFFFFFFFFFFFFFFWFFFW
WFFFGFFFFFFFFFFFFFFFFFFFFGFFFW
WFFFWGWWWWWWWWWWWWWWWWWWGWFFFW
WFFFFFFFFFFFFFFFFFFFFFFFFFFFFW
WFFFFFFFFFFFFFFFFFFFFFFFFFFFFW
GFFFFFFFFFFFFFFFFFFFFFFFFFFFFG
WGWWWWWWWWWWWWWWWWWWWWWWWWWWGW
