30
WWWWWWWWWWWWWWWWWWWWWWWWWWWWWW
WFFFFFFFFFWFFFFFFFFFFFFFWFFFFW
WFFWFWWWWFWFWWWWWFWWWFWWWFWFFW
WFWFFFWFWFFFFFFFFFFFWFWFFFWFWW
WFWWWWWFWWWFWWFWWWWWWWWFWFWFWW
WFFFFFWFWFFFWFFWFFFFFFWFWFWFFW
WWWFWWWFWWWFWWFWFWWWWFWFWFWFWW
WFFFFFFFFFWFFWFWFWFFFFFFWFFFWW
WWWWFWWFWWWFWWWWFWWWWWWFWFWWWW
WFFFFWFFWFFFWFFWFFFFWFFFFFWFFW
WFWWWWWWWFWWWFFWFWWWWFWFWFWFFW
WFWFFFFFFFWFFFFWFWFFFFWFWFFFWW
WWWFWWWFWWWFFWWWFWFWWFWFWWWFWW
WFFFWFWFFFFFWWFFFWFWFFWFWFFFWW
WFWFWFWWWFWWWFFWFWWWFWWFWFWWWW
WFFFFFWFFFWFFFFWFWFFFWFFWFFFFW
WFWFWWWWWWWFFWWWFFWWWFWFFWFFFW
WFFFWFWWWFFWFWFFFWFFWFFFWFWFWW
WFFFWFWFWFWFFFWFWFWFFFWFWFFFWW
WWFWWFFFFFWWWFFFWFFFWWWWWWFFWW
WFFFWWWFWWWFWWWWWWFWWWFFFFFFFW
WFWFWFFFWFFFWWFFFWFFFFFWWFFFFW
WFFFWWWFFFWWWFFWWWWWFWFWFFWWWW
WFWFWFFFWWWWFWFWWFFFFFFWWFFFWW
WFFFWFFFFFFFFFFWFFWWWFFWWWWWWW
WFWFFFWWFFWWFFWWWWWFWFFFWWWWWW
WWWFWWWWWWWFFWWWFWWFFFWFWWWWWW
WWFFFFFFFFFFFFFFFFFFWFFFWWFFFW
WWWFWWWWFFFFFFWWWWFWWWFFFFFFWW
WWWWWWWWWWWWWWWWWWWWWWWWWWWWWW

