30
WGWWWWWWWWWWWWWWWWWWWWWWWWWWWW
WFFFFFFFFFFFFFWWFFFFFFFFFFFFFW
WFFWWWWWWFWWWFWWFWWWFWWWWWWFFW
WFFFFFFFWFWFWFWWFWFWFWFFFFFFFW
WFFFFFWFFFFFFFGWFFFFFFFWFFFFFW
WFFFFWWFFFFFFFFFFFFFFFFWWFFFFW
WFFWFWFFFWWWWWWWWWWWWFFFWFWFFW
WFFWFFFFFFFFFFFFFFFFFFFFFFWFFW
WFFWFFFFFFFFFFFFFFFFFFFFFFWFFW
WFFWWWWWFFWWWFFFFWWWFFWWWWWFFW
WFFFFFFWFFWFFFFFFFFWFFWFFFFFFW
WFFFFFFWFFWFFFFFFFFWFFWFFFFFFW
WFFFWFFFFFWFFFIIFFFWFFFFFWFFFW
WFFFWFFFFFFFFFFFFFFFFFFFFWFFFW
WFFFWWGWWFFIFFWWFFIFFWWWWWFFFW
WFFFWWWWWFFIFFWWFFIFFWWWWWFFFW
WFFFWFFFFFFIFFFFFFFFFFFFFWFFFW
WFFFWFFFFFWIFFIIFFFWFFFFFWFFFW
WFFFFFFWFFWIFFFFFFFWFFWFFFFFFW
WFFFFFFWFFWIIIIIIIIWFFWFFFFFFW
WFFWWWWWFFWWWFFFFWWWFFWWWWWFFW
WFFWFFFFFFFFFFFFFFFFFFFFFFWFFW
WFFWFFFFFFFFFFFFFFFFFFFFFFWFFW
WFFWFWFFFWWWWWWWWWWWWFFFWFWFFW
WFFFFWWFFFFFFFFFFFFFFFFWWFFFFW
WFFFFFWFFFFFFFWGFFFFFFFWFFFFFW
WFFFFFFFWFWFWFWWFWFWFWFFFFFFFW
WFFWWWWWWFWWWFWWFWWWFWWWWWWFFW
WFFFFFFFFFFFFFWWFFFFFFFFFFFFFW
WWWWWWWWWWWWWWWWWWWWWWWWWWWWGW