30
WWWWWWWWWWWWWWWWWWWWWWWWWWWWWW
WFFFFFFFFFFFFFFFFFFFFFFFFFFFFW
WFFWWWWWWFWWWFWWFWWWFWWWWWWFFW
WFFFFFFFWFWFWFWWFWFWFWFFFFFFFW
WFFFFFWFFFFFFFWWFFFFFFFWFFFFFW
WFFFFWWFFFFFFFFFFFFFFFFWWFFFFW
WFFWFWFFFWWWWWWWWWWWWFFFWFWFFW
WFFWFFFFFFFIIIIIIIIIFFFFFFWFFW
WFFWFIIIIFFFFFFFFFFFFFFFFFWFFW
WFFWWWWWFFWFFFFFFFFWFFWWWWWFFW
WFFFFFFWFFWFFFFFFFFWFFWFFFFFFW
WFFFFFFWFFWFFFFFFFFWFFWFFFFFFW
WFFFWFFFFFWFFFFFFFFWFFFFFWFFFW
WFFFWFFFFFFFFFWWFFFFFFFFFWFFFW
WFFFWWWWWFFFFWWWWFFFFWWWWWFFFW
WFFFWWWWWFFFFWWWWFFFFWWWWWFFFW
WFFFWFFFFFFFFFWWFFFFFFFFFWFFFW
WFFFWFFFFFWFFFFFFFFWFFFFFWFFFW
WFFFFFFWFFWFFFFFFFFWFFWFFFFFFW
WFFFFFFWFFWFFFFFFFFWFFWFFFFFFW
WFFWWWWWFFWWWFFFFWWWFFWWWWWFFW
WFFWFFFFFFFFFFFFFFFFFFFFFFWFFW
WFFWFFFFFFFFFFFFFFFFFFFFFFWFFW
WFFWFWFFFWWWWWWWWWWWWFFFWFWFFW
WFFFFWWFFFFFFFFFFFFFFFFWWFFFFW
WFFFFFWFFFFFFFWWFFFFFFFWFFFFFW
WFFFFFFFWFWFWFWWFWFWFWFFFFFFFW
WFFWWWWWWFWWWFWWFWWWFWWWWWWFFW
WFFFFFFFFFFFFFFFFFFFFFFFFFFFFW
WWWWWWWWWWWWWWWWWWWWWWWWWWWWWW