30
WWWWWWWWWWWWWWWWWWWWWWWWWWWWWW
WGFFGFFGFFGFFGFFGFFGFFGFFGFFGW
WFGFFGFFGFFGFFGFFGFFGFFGFFGFFW
WFFGFFGFFGFFGFFGFFGFFGFFGFFGFW
WGFFGFFGFFGFFGFFGFFGFFGFFGFFGW
WFGFFGFFGFFGFFGFFGFFGFFGFFGFFW
WFFGFFGFFGFFGFFGFFGFFGFFGFFGFW
WGFFGFFGFFGFFGFFGFFGFFGFFGFFGW
WFGFFGFFGFFGFFGFFGFFGFFGFFGFFW
WFFGFFGFFGFFGFFGFFGFFGFFGFFGFW
WGFFGFFGFFGFFGFFGFFGFFGFFGFFGW
WFGFFGFFGFFGFFGFFGFFGFFGFFGFFW
WFFGFFGFFGFFGFFGFFGFFGFFGFFGFW
WGFFGFFGFFGFFGFFGFFGFFGFFGFFGW
WFGFFGFFGFFGFFGFFGFFGFFGFFGFFW
WFFGFFGFFGFFGFFGFFGFFGFFGFFGFW
WGFFGFFGFFGFFGFFGFFGFFGFFGFFGW
WFGFFGFFGFFGFFGFFGFFGFFGFFGFFW
WFFGFFGFFGFFGFFGFFGFFGFFGFFGFW
WGFFGFFGFFGFFGFFGFFGFFGFFGFFGW
WFGFFGFFGFFGFFGFFGFFGFFGFFGFFW
WFFGFFGFFGFFGFFGFFGFFGFFGFFGFW
WGFFGFFGFFGFFGFFGFFGFFGFFGFFGW
WFGFFGFFGFFGFFGFFGFFGFFGFFGFFW
WFFGFFGFFGFFGFFGFFGFFGFFGFFGFW
WGFFGFFGFFGFFGFFGFFGFFGFFGFFGW
WFGFFGFFGFFGFFGFFGFFGFFGFFGFFW
WFFGFFGFFGFFGFFGFFGFFGFFGFFGFW
WGFFGFFGFFGFFGFFGFFGFFGFFGFFGW
WWWWWWWWWWWWWWWWWWWWWWWWWWWWWW
