30
WWWWWWWWWWWWWWWWWWWWWWWWWWWWWW
WGFFGFFGFFGFFGFFGFFGFFGFFGFFGW
WFFFFGFFGFFGFFGFFGFFGFFGFFGFFW
WFFGFFGFFGFFGFFGFFGFFGFFGFFGFW
WGFFGFFGFFGFFGFFGFFGFFGFFGFFGW
WFGFFGFFGFFGFFGFFGFFGFFGFFGFFW
WFFGFFGFFGFFGFFGFFGFFGFFGFFGFW
WGFFGFFGFFGFFGFFGFFGFFGFFGFFGW
WFGFFGFFGFFGFFGFFGFFGFFGFFGFFW
WFFGFFGFFGFFGFFGFFGFFGFFGFFGFW
WGFFGFFGFFGFFGFFGFFGFFGFFGFFGW
WFGFFGFFGFFGFFGFFGFFGFFGFFGFFW
WFFGFFGFFGFFGFFGFFGFFGFFGFFGFW
WGFFGFFGFFGFFGFFGFFGFFGFFGFFGW
WFGFFGFFGFFGFFGFFGFFGFFGFFGFFW
WFFGFFGFFGFFGFFGFFGFFGFFGFFFFW
WGFFGFFGFFGFFGFFGFFGFFGFFGFFGW
WFGFFGFFGFFGFFGFFGFFGFFGFFGFFW
WFFGFFGFFGFFGFFGFFGFFGFFGFFGFW
WGFFGFFGFFGFFGFFGFFGFFGFFGFFGW
WFGFFGFFGFFGFFGFFGFFGFFGFFGFFW
WFFGFFGFFGFFGFFGFFGFFGFFGFFGFW
WGFFGFFGFFGFFGFFGFFGFFGFFGFFGW
WFGFFGFFGFFGFFGFFGFFGFFGFFGFFW
WFFGFFGFFGFFGFFGFFGFFGFFGFFGFW
WGFFGFFGFFGFFGFFGFFGFFGFFGFFGW
WFGFFGFFGFFGFFGFFGFFGFFGFFGFFW
WFFGFFGFFGFFGFFGFFGFFGFFGFFFFW
WGFFGFFGFFGFFGFFGFFGFFGFFGFFGW
WWWWWWWWWWWWWWWWWWWWWWWWWWWWWW
