30
WPWWWWWWWWWWWWWWWWWWWWWWWWWWWW
WIIFFFFFFFFFFFWWFFFFFFFFFFFFFW
WFFWWWWWWFWWWFWWFWWWFWWWWWWFFW
WFFFFFFFWFWFWFWWFWFWFWFFFFFFFW
WFFFFFWFFFFFFFPWFFFFFFFWFFFFFW
WFFFFWWFFFFFFFFFFFFFFFFWWFFFFW
WFFWFWFFFWWWWWWWWWWWWFFFWFWFFW
WFFWFFFFFFFIIIIIIIIIFFFFFFWFFW
WFFWFIIIIFFFFFFFFFFFFFFFFFWFFW
WFFWWWWWFFWWWFFFFWWWFFWWWWWFFW
WFFFFFFWFFWFFFFFFFFWFFWFFFFFFW
WFFFFFFWFFWFFFFFFFFWFFWFFFFFFW
WFFFWFFFFFWFFFFFFFFWFFFFFWFFFW
WFFFWFFFFFFFFFFFFFFFFFFFFWFFFW
WFFFWWWWWFFFFFWWFFFFFWWWWWFFFW
WFFFWWWWWFFFFFWWFFFFFWWWWWFFFW
WFFFWFFFFFFFFFFFFFFFFFFFFWFFFW
WFFFWFFFFFWFFFFFFFFWFFFFFWFFFW
WFFFFFFWFFWFFFFFFFFWFFWFFFFFFW
WFFFFFFWFFWFFFFFFFFWFFWFFFFFFW
WFFWWWWWFFWWWFFFFWWWFFWWWWWFFW
WFFWFFFFFFFFFFFFFFFFFFFFFFWFFW
WFFWFFFFFFFFFFFFFFFFFFFFFFWFFW
WFFWFWFFFWWWWWWWWWWWWFFFWFWFFW
WFFFFWWFFFFFFFFFFFFFFFFWWFFFFW
WFFFFFWFFFFFFFWPFFFFFFFWFFFFFW
WFFFFFFFWFWFWFWWFWFWFWFFFFFFFW
WFFWWWWWWFWWWFWWFWWWFWWWWWWFFW
WFFFFFFFFFFFFFWWFFFFFFFFFFFFFW
WWWWWWWWWWWWWWWWWWWWWWWWWWWWPW