30
WGWWWWWWWWWWWWWWWWWWWWWWWWWWWW
WFFFFFFFFFFFFFWWFFFFFFFFFFFFFW
WFFWWWWWWFWWWFWWFWWWFWWWWWWFFW
WFFFFFFFWFWFWFWWFWFWFWFFFFFFFW
WFFFFFWFFFFFFFGWFFFFFFFWFFFFFW
WFFFFWWFFFFFFFFFFFFFFFFWWFFFFW
WFFWFWFFFWWWWWWWWWWWWFFFWFWFFW
WFFWFFFFFFFIIIIIIIIIFFFFFFWFFW
WFFWFIIIIFFFFFFFFFFFFFFFFFWFFW
WFFWWWWWFFWWWFFFFWWWFFWWWWWFFW
WFFFFFFWFFWFFFFFFFFWFFWFFFFFFW
WFFFFFFWFFWFFFFFFFFWFFWFFFFFFW
WFFFWFFFFFWFFFFFFFFWFFFFFWFFFW
WFFFWFFFFFFFFFFFFFFFFFFFFWFFFW
WFFFGWWWWFFFFFWWFFFFFWWWWWFFFW
WFFFWWWWWFFFFFWWFFFFFWWWWWFFFW
WFFFWFFFFFFFFFFFFFFFFFFFFWFFFW
WFFFWFFFFFWFFFFFFFFWFFFFFWFFFW
WFFFFFFWFFWFFFFFFFFWFFWFFFFFFW
WFFFFFFWFFWFFFFFFFFWFFWFFFFFFW
WFFWWWWWFFWWWFFFFWWWFFWWWWWFFW
WFFWFFFFFFFFFFFFFFFFFFFFFFWFFW
WFFWFFFFFFFFFFFFFFFFFFFFFFWFFW
WFFWFWFFFWWWWWWWWWWWWFFFWFWFFW
WFFFFWWFFFFFFFFFFFFFFFFWWFFFFW
WFFFFFWFFFFFFFWGFFFFFFFWFFFFFW
WFFFFFFFWFWFWFWWFWFWFWFFFFFFFW
WFFWWWWWWFWWWFWWFWWWFWWWWWWFFW
WFFFFFFFFFFFFFWWFFFFFFFFFFFFFW
WWWWWWWWWWWWWWWWWWWWWWWWWWWWGW