30
WWWWWWWWWWWWWWWWWWWWWWWWWWWWWW
WIIFFFFFFFFFFFWWFFFFFFFFFFFFFW
WFFWWWWWWFWWWFWWFWWWFWWWWWWFFW
WFFFFFFFWFWFWFWWFWFWFWFFFFFFFW
WFFFFFWFFFFFFFWWFFFFFFFWFFFFFW
WFFFFWWFFFFFFFFFFFFFFFFWWFFFFW
WFFWFWFFFWWWWWWWWWWWWFFFWFWFFW
WFFWFFFFFFFFFFFFFFFFFFFFFFWFFW
WFFWFIIIIFFFFFFFFFFFFFFFFFWFFW
WFFWWWWWFFWWWFFFFWWWFFWWWWWFFW
WFFFFFFWFFWFFFFFFFFWFFWFFFFFFW
WFFFFFFWFFWFFFFFFFFWFFWFFFFFFW
WFFFWFFFFFWFFFFFFFFWFFFFFWFFFW
WFFFWFFFFFFFFFFFFFFFFFFFFWFFFW
WFFFWWWWWFFFFFWWFFFFFWWWWWFFFW
WFFFWWWWWFFFFFWWFFFFFWWWWWFFFW
WFFFWFFFFFFFFFFFFFFFFFFFFWFFFW
WFFFWFFFFFWFFFFFFFFWFFFFFWFFFW
WFFFFFFWFFWFFFFFFFFWFFWFFFFFFW
WFFFFFFWFFWFFFFFFFFWFFWFFFFFFW
WFFWWWWWFFWWWFFFFWWWFFWWWWWFFW
WFFWFFFFFFFFFFFFFFFFFFFFFFWFFW
WFFWFFFFFFFFFFFFFFFFFFFFFFWFFW
WFFWFWFFFWWWWWWWWWWWWFFFWFWFFW
WFFFFWWFFFFFFFFFFFFFFFFWWFFFFW
WFFFFFWFFFFFFFWWFFFFFFFWFFFFFW
WFFFFFFFWFWFWFWWFWFWFWFFFFFFFW
WFFWWWWWWFWWWFWWFWWWFWWWWWWFFW
WFFFFFFFFFFFFFWWFFFFFFFFFFFFFW
WWWWWWWWWWWWWWWWWWWWWWWWWWWWWW
